Time,Team,Operation,BuyVolume,SellVolume,EtfPosition,FuturePosition,EtfPrice,FuturePrice,TotalFees,AccountBalance,ProfitOrLoss,Status
0.0,auto,Tick,0,0,0,0,,,0,0,0,OK
0.219,auto,Tick,0,0,0,0,,,0,0,0,OK
0.469,auto,Tick,0,0,0,0,,,0,0,0,OK
0.797,auto,Tick,0,10,-10,10,147600,,-147,147,147,OK
1.032,auto,Tick,0,10,-10,10,147600,147100,-147,147,-1853,OK
1.297,auto,Tick,1,10,-9,9,147000,147100,-162,262,1162,OK
1.547,auto,Tick,1,10,-9,9,147000,147100,-162,262,1162,OK
1.766,auto,Tick,1,10,-9,9,147000,147100,-162,262,1162,OK
1.985,auto,Tick,1,10,-9,9,147000,147100,-162,262,1162,OK
2.282,auto,Tick,1,10,-9,9,147000,146900,-162,262,-638,OK
2.532,auto,Tick,11,10,1,-1,146400,146900,-309,-1591,-1791,OK
2.719,auto,Tick,11,10,1,-1,146400,146900,-309,-1591,-1791,OK
2.953,auto,Tick,11,10,1,-1,146400,146900,-309,-1591,-1791,OK
3.25,auto,Tick,11,10,1,-1,146400,146900,-309,-1591,-1791,OK
3.516,auto,Tick,11,20,-9,9,147500,146900,-456,-1444,-3244,OK
3.766,auto,Tick,21,20,1,-1,146300,146900,-603,-2297,-2497,OK
4.047,auto,Tick,21,20,1,-1,146300,146900,-603,-2297,-2497,OK
4.266,auto,Tick,21,20,1,-1,146300,146900,-603,-2297,-2497,OK
4.485,auto,Tick,21,20,1,-1,146300,146900,-603,-2297,-2497,OK
4.719,auto,Tick,31,20,11,-11,146300,146900,-750,-2150,-4350,OK
5.0,auto,Tick,31,20,11,-11,146300,146900,-750,-2150,-4350,OK
5.25,auto,Tick,31,20,11,-11,146300,146800,-750,-2150,-4350,OK
5.516,auto,Tick,31,20,11,-11,146300,146800,-750,-2150,-4350,OK
5.703,auto,Tick,31,20,11,-11,146300,146800,-750,-2150,-4350,OK
6.016,auto,Tick,31,30,1,-1,147000,146800,-456,-2444,-2244,OK
6.25,auto,Tick,31,40,-9,9,147000,146800,-162,-1738,-3538,OK
6.547,auto,Tick,31,50,-19,19,147000,146800,132,968,-2832,OK
6.766,auto,Tick,31,60,-29,29,147200,146700,426,3674,-2126,OK
7.047,auto,Tick,31,60,-29,29,147200,146900,426,3674,-2126,OK
7.266,auto,Tick,31,60,-29,29,147200,146900,426,3674,-2126,OK
7.469,auto,Tick,31,60,-29,29,147200,146900,426,3674,-2126,OK
7.719,auto,Tick,31,60,-29,29,147200,146900,426,3674,-2126,OK
8.0,auto,Tick,31,60,-29,29,147200,146900,426,3674,-2126,OK
8.25,auto,Tick,41,60,-19,19,147000,146900,279,821,-1079,OK
8.453,auto,Tick,41,60,-19,19,147000,146900,279,821,-1079,OK
8.797,auto,Tick,41,60,-19,19,147000,146900,279,821,-1079,OK
9.016,auto,Tick,51,60,-9,9,146700,146900,132,-1032,768,OK
9.266,auto,Tick,61,60,1,-1,146400,146900,425,1675,1475,OK
9.5,auto,Tick,71,60,11,-11,146400,146900,718,4382,2182,OK
9.703,auto,Tick,81,60,21,-21,146400,146900,1011,6089,1889,OK
10.032,auto,Tick,81,60,21,-21,146400,146900,1011,6089,1889,OK
10.219,auto,Tick,91,60,31,-31,146400,146900,1304,7796,1596,OK
10.469,auto,Tick,101,60,41,-41,146400,146900,1597,10503,2303,OK
10.75,auto,Tick,111,70,41,-41,146500,147000,1744,7356,-844,OK
10.969,auto,Tick,111,80,31,-31,147300,147000,1597,3503,9703,OK
11.282,auto,Tick,111,80,31,-31,147300,147000,1597,3503,9703,OK
11.453,auto,Tick,111,80,31,-31,147300,147000,1597,3503,9703,OK
11.766,auto,Tick,111,90,21,-21,147400,147200,1450,650,4850,OK
11.953,auto,Tick,111,90,21,-21,147400,147200,1450,650,4850,OK
12.282,auto,Tick,111,90,21,-21,147400,147200,1450,650,4850,OK
12.516,auto,Tick,111,90,21,-21,147400,147200,1450,650,4850,OK
12.735,auto,Tick,111,90,21,-21,147400,147200,1450,650,4850,OK
13.0,auto,Tick,111,90,21,-21,147400,147200,1450,650,4850,OK
13.297,auto,Tick,121,90,31,-31,146700,147200,1303,2797,-3403,OK
13.453,auto,Tick,121,90,31,-31,146700,147200,1303,2797,-3403,OK
13.782,auto,Tick,121,90,31,-31,146700,147200,1303,2797,-3403,OK
14.047,auto,Tick,121,97,24,-24,146700,147200,1508,492,-4308,OK
14.297,auto,Tick,121,97,24,-24,146700,147200,1508,492,-4308,OK
14.5,auto,Tick,121,97,24,-24,146700,147200,1508,492,-4308,OK
14.735,auto,Tick,121,97,24,-24,146700,147200,1508,492,-4308,OK
14.969,auto,Tick,121,97,24,-24,146700,147200,1508,492,-4308,OK
15.328,auto,Tick,121,97,24,-24,146700,147200,1508,492,-4308,OK
15.547,auto,Tick,121,97,24,-24,146900,146800,1508,492,2892,OK
15.797,auto,Tick,121,97,24,-24,146900,146900,1508,492,492,OK
16.016,auto,Tick,121,97,24,-24,146900,146900,1508,492,492,OK
16.297,auto,Tick,121,107,14,-14,146600,146900,1801,-1801,-4601,OK
16.469,auto,Tick,121,107,14,-14,146600,146900,1801,-1801,-4601,OK
16.797,auto,Tick,121,107,14,-14,146600,146900,1801,-1801,-4601,OK
17.0,auto,Tick,121,107,14,-14,146600,146900,1801,-1801,-4601,OK
17.266,auto,Tick,121,107,14,-14,146600,146900,1801,-1801,-4601,OK
17.5,auto,Tick,121,107,14,-14,146600,146900,1801,-1801,-4601,OK
17.735,auto,Tick,131,107,24,-24,146900,146900,2095,-1095,-1095,OK
18.0,auto,Tick,141,107,34,-34,146600,146900,1948,1052,-5748,OK
18.313,auto,Tick,141,107,34,-34,146600,146900,1948,1052,-5748,OK
18.453,auto,Tick,141,107,34,-34,146600,147100,1948,1052,-5748,OK
18.782,auto,Tick,141,107,34,-34,146600,147100,1948,1052,-5748,OK
18.953,auto,Tick,141,107,34,-34,146600,147100,1948,1052,-5748,OK
19.266,auto,Tick,141,107,34,-34,146600,147100,1948,1052,-5748,OK
19.485,auto,Tick,141,107,34,-34,146600,147200,1948,1052,-5748,OK
19.766,auto,Tick,141,107,34,-34,146600,147200,1948,1052,-5748,OK
20.032,auto,Tick,141,107,34,-34,146600,147200,1948,1052,-5748,OK
20.203,auto,Tick,151,107,44,-44,146900,147200,2242,3758,-5042,OK
20.532,auto,Tick,161,107,54,-54,146900,147900,2536,8464,-2336,OK
20.75,auto,Tick,171,117,54,-64,147500,147900,2683,1490317,517,OK
20.953,auto,Tick,171,123,48,-48,147600,147900,2860,9340,-260,OK
21.266,auto,Tick,171,123,48,-48,147600,147900,2860,9340,-260,OK
21.516,auto,Tick,171,123,48,-48,147600,147900,2860,9340,-260,OK
21.782,auto,Tick,171,123,48,-48,147600,147900,2860,9340,-260,OK
22.047,auto,Tick,171,123,48,-48,147600,148000,2860,9340,-260,OK
22.235,auto,Tick,171,123,48,-48,147600,148000,2860,9340,-260,OK
22.516,auto,Tick,171,123,48,-48,147600,148100,2860,9340,-260,OK
22.75,auto,Tick,171,123,48,-48,147600,148100,2860,9340,-260,OK
22.985,auto,Tick,171,123,48,-48,147600,148000,2860,9340,-260,OK
23.25,auto,Tick,171,123,48,-48,147600,148000,2860,9340,-260,OK
23.547,auto,Tick,171,133,38,-38,147400,147700,3155,6045,-1555,OK
23.766,auto,Tick,171,133,38,-38,147400,147700,3155,6045,-1555,OK
24.063,auto,Tick,171,133,38,-38,147400,147700,3155,6045,-1555,OK
24.282,auto,Tick,181,133,48,-48,147400,147700,3450,8750,-850,OK
24.485,auto,Tick,191,133,58,-58,147400,147700,3745,11455,-145,OK
24.797,auto,Tick,191,133,58,-58,147400,148100,3745,11455,-145,OK
25.0,auto,Tick,191,133,58,-58,147400,148100,3745,11455,-145,OK
25.297,auto,Tick,201,133,68,-68,147700,148200,4040,16160,2560,OK
25.485,auto,Tick,201,143,58,-58,147600,147900,4335,9865,-1735,OK
25.703,auto,Tick,201,150,51,-51,147600,147900,4232,6468,-3732,OK
26.016,auto,Tick,201,150,51,-51,147600,147900,4232,6468,-3732,OK
26.219,auto,Tick,201,150,51,-51,147600,147900,4232,6468,-3732,OK
26.469,auto,Tick,201,150,51,-51,147400,147900,4232,6468,-3732,OK
26.703,auto,Tick,201,150,51,-51,147400,147900,4232,6468,-3732,OK
26.969,auto,Tick,201,150,51,-51,147400,147900,4232,6468,-3732,OK
27.203,auto,Tick,211,150,61,-61,147400,147900,4085,11615,-585,OK
27.516,auto,Tick,211,150,61,-61,147400,147900,4085,11615,-585,OK
27.75,auto,Tick,211,150,61,-61,147400,147900,4085,11615,-585,OK
28.0,auto,Tick,221,160,61,-61,147200,147800,4233,9467,-2733,OK
28.203,auto,Tick,221,170,51,-51,147200,147800,4527,3173,-7027,OK
28.469,auto,Tick,221,180,41,-41,147700,147800,4380,-1680,-5780,OK
28.735,auto,Tick,221,180,41,-41,147700,147600,4380,-1680,2420,OK
28.985,auto,Tick,221,180,41,-41,147700,147600,4380,-1680,2420,OK
29.235,auto,Tick,221,180,41,-41,147700,147600,4380,-1680,2420,OK
29.547,auto,Tick,221,180,41,-41,147700,147600,4380,-1680,2420,OK
29.813,auto,Tick,221,190,31,-31,147100,147600,4674,-4974,-11174,OK
30.016,auto,Tick,221,200,21,-21,147700,147600,4527,-7827,-5727,OK
30.297,auto,Tick,231,200,31,-31,147000,147600,4821,-6121,-12321,OK
30.547,auto,Tick,231,200,31,-31,147000,147600,4821,-6121,-12321,OK
30.703,auto,Tick,231,200,31,-31,147000,147400,4821,-6121,-12321,OK
31.047,auto,Tick,241,200,41,-41,147000,147400,5115,-3415,-11615,OK
31.203,auto,Tick,251,200,51,-51,147000,147400,5409,291,-9909,OK
31.532,auto,Tick,261,200,61,-61,147000,147400,5703,4997,-7203,OK
31.797,auto,Tick,261,200,61,-61,147000,147400,5703,4997,-7203,OK
32.047,auto,Tick,261,210,51,-51,147100,147400,5556,-1856,-12056,OK
32.203,auto,Tick,261,210,51,-51,147100,147400,5556,-1856,-12056,OK
32.485,auto,Tick,261,210,51,-51,147100,147400,5556,-1856,-12056,OK
32.735,auto,Tick,261,210,51,-51,147100,147600,5556,-1856,-12056,OK
33.016,auto,Tick,261,210,51,-51,147100,147600,5556,-1856,-12056,OK
33.266,auto,Tick,261,220,41,-41,146900,147600,5850,-7150,-15350,OK
33.547,auto,Tick,261,220,41,-41,146900,147600,5850,-7150,-15350,OK
33.782,auto,Tick,261,230,31,-31,146900,147600,6144,-11444,-17644,OK
33.953,auto,Tick,261,230,31,-31,146900,147600,6144,-11444,-17644,OK
34.266,auto,Tick,261,230,31,-31,146900,147200,6144,-11444,-17644,OK
34.5,auto,Tick,261,230,31,-31,146900,147200,6144,-11444,-17644,OK
34.75,auto,Tick,261,230,31,-31,146900,147200,6144,-11444,-17644,OK
35.063,auto,Tick,261,230,31,-31,146900,147200,6144,-11444,-17644,OK
35.203,auto,Tick,261,230,31,-31,146900,147300,6144,-11444,-17644,OK
35.532,auto,Tick,261,240,21,-21,147100,147000,5997,-16297,-14197,OK
35.766,auto,Tick,261,250,11,-11,147200,147000,6291,-17591,-15391,OK
36.0,auto,Tick,261,250,11,-11,147200,147000,6291,-17591,-15391,OK
36.203,auto,Tick,261,250,11,-11,147200,147000,6291,-17591,-15391,OK
36.547,auto,Tick,261,257,4,-4,147200,147000,6497,-18497,-17697,OK
36.735,auto,Tick,261,257,4,-4,147200,147000,6497,-18497,-17697,OK
37.047,auto,Tick,261,257,4,-4,147200,147000,6497,-18497,-17697,OK
37.266,auto,Tick,261,257,4,-4,147200,147000,6497,-18497,-17697,OK
37.516,auto,Tick,261,257,4,-4,147200,147300,6497,-18497,-18897,OK
37.766,auto,Tick,261,257,4,-4,147200,147300,6497,-18497,-18897,OK
38.047,auto,Tick,261,257,4,-4,147200,147300,6497,-18497,-18897,OK
38.266,auto,Tick,261,257,4,-4,147200,147300,6497,-18497,-18897,OK
38.485,auto,Tick,261,257,4,-4,147200,147300,6497,-18497,-18897,OK
38.782,auto,Tick,261,257,4,-4,147200,147300,6497,-18497,-18897,OK
38.985,auto,Tick,271,257,14,-14,147500,147300,6792,-18792,-15992,OK
39.25,auto,Tick,281,257,24,-24,147000,147300,6645,-17645,-22445,OK
39.547,auto,Tick,281,267,14,-14,147700,147300,6497,-18497,-15697,OK
39.75,auto,Tick,281,267,14,-14,147700,147300,6497,-18497,-15697,OK
40.032,auto,Tick,281,267,14,-14,147700,147300,6497,-18497,-15697,OK
40.25,auto,Tick,281,267,14,-14,147700,147300,6497,-18497,-15697,OK
40.485,auto,Tick,281,277,4,-4,147700,147300,6350,-19350,-18550,OK
40.797,auto,Tick,281,277,4,-4,147700,147300,6350,-19350,-18550,OK
41.047,auto,Tick,281,277,4,-4,147700,147300,6350,-19350,-18550,OK
41.203,auto,Tick,281,277,4,-4,147700,147300,6350,-19350,-18550,OK
41.469,auto,Tick,281,277,4,-4,147700,147300,6350,-19350,-18550,OK
41.766,auto,Tick,281,277,4,-4,147700,147300,6350,-19350,-18550,OK
42.032,auto,Tick,281,277,4,-4,147700,147300,6350,-19350,-18550,OK
42.297,auto,Tick,281,285,-4,4,147500,147200,6232,-18432,-19232,OK
42.532,auto,Tick,281,285,-4,4,147500,147200,6232,-18432,-19232,OK
42.75,auto,Tick,281,285,-4,4,147500,147200,6232,-18432,-19232,OK
43.016,auto,Tick,281,285,-4,4,147500,147200,6232,-18432,-19232,OK
43.25,auto,Tick,281,285,-4,4,147500,147200,6232,-18432,-19232,OK
43.5,auto,Tick,281,285,-4,4,147500,147200,6232,-18432,-19232,OK
43.797,auto,Tick,281,285,-4,4,147500,147400,6232,-18432,-18832,OK
44.0,auto,Tick,281,285,-4,4,147500,147400,6232,-18432,-18832,OK
44.25,auto,Tick,281,285,-4,4,147500,147400,6232,-18432,-18832,OK
44.563,auto,Tick,281,285,-4,4,147500,147400,6232,-18432,-18832,OK
44.75,auto,Tick,281,285,-4,4,147500,147400,6232,-18432,-18832,OK
45.016,auto,Tick,281,285,-4,4,147700,147400,6232,-18432,-19232,OK
45.25,auto,Tick,281,285,-4,4,147700,147500,6232,-18432,-19232,OK
45.516,auto,Tick,281,285,-4,4,147700,147500,6232,-18432,-19232,OK
45.735,auto,Tick,281,295,-14,14,147400,147500,6527,-18727,-17327,OK
45.985,auto,Tick,281,295,-14,14,147400,147500,6527,-18727,-17327,OK
46.203,auto,Tick,281,295,-14,14,147400,147500,6527,-18727,-17327,OK
46.547,auto,Tick,281,295,-14,14,147400,147500,6527,-18727,-17327,OK
46.782,auto,Tick,281,295,-14,14,147400,147500,6527,-18727,-17327,OK
46.985,auto,Tick,281,303,-22,22,147400,147500,6763,-17363,-15163,OK
47.297,auto,Tick,281,303,-22,22,147400,147500,6763,-17363,-15163,OK
47.5,auto,Tick,281,303,-22,22,147400,147500,6763,-17363,-15163,OK
47.797,auto,Tick,281,303,-22,22,147700,147500,6763,-17363,-21763,OK
48.016,auto,Tick,281,303,-22,22,147700,147500,6763,-17363,-21763,OK
48.25,auto,Tick,281,303,-22,22,147700,147500,6763,-17363,-21763,OK
48.485,auto,Tick,291,303,-12,12,147100,147500,6616,-21216,-18816,OK
48.797,auto,Tick,291,303,-12,12,147100,147500,6616,-21216,-18816,OK
48.969,auto,Tick,291,303,-12,12,147100,147500,6616,-21216,-18816,OK
49.219,auto,Tick,291,303,-12,12,147100,147500,6616,-21216,-18816,OK
49.547,auto,Tick,291,303,-12,12,147100,147500,6616,-21216,-18816,OK
49.735,auto,Tick,291,303,-12,12,147100,147500,6616,-21216,-18816,OK
50.0,auto,Tick,291,303,-12,12,147100,147500,6616,-21216,-18816,OK
50.297,auto,Tick,291,303,-12,12,147100,147500,6616,-21216,-18816,OK
50.469,auto,Tick,291,303,-12,12,147700,147500,6616,-21216,-23616,OK
50.703,auto,Tick,291,303,-12,12,147700,147500,6616,-21216,-23616,OK
51.016,auto,Tick,291,303,-12,12,147700,147500,6616,-21216,-23616,OK
51.266,auto,Tick,291,303,-12,12,147700,147500,6616,-21216,-23616,OK
51.516,auto,Tick,291,303,-12,12,147700,147500,6616,-21216,-23616,OK
51.797,auto,Tick,291,303,-12,12,147700,147500,6616,-21216,-23616,OK
52.0,auto,Tick,291,303,-12,12,147700,147300,6616,-21216,-23616,OK
52.25,auto,Tick,291,303,-12,12,147700,147300,6616,-21216,-23616,OK
52.547,auto,Tick,291,303,-12,12,147700,147300,6616,-21216,-23616,OK
52.719,auto,Tick,291,303,-12,12,147700,147300,6616,-21216,-23616,OK
53.047,auto,Tick,291,303,-12,12,147700,147300,6616,-21216,-23616,OK
53.25,auto,Tick,291,303,-12,12,147700,147300,6616,-21216,-23616,OK
53.547,auto,Tick,291,303,-12,12,147700,147300,6616,-21216,-23616,OK
53.719,auto,Tick,291,303,-12,12,147700,147300,6616,-21216,-23616,OK
53.953,auto,Tick,291,303,-12,12,147700,147300,6616,-21216,-23616,OK
54.266,auto,Tick,291,309,-18,18,147800,147300,6527,-19927,-23527,OK
54.469,auto,Tick,291,309,-18,18,147800,147200,6527,-19927,-23527,OK
54.766,auto,Tick,291,309,-18,18,147800,147200,6527,-19927,-23527,OK
54.953,auto,Tick,291,309,-18,18,147800,147200,6527,-19927,-23527,OK
55.282,auto,Tick,291,309,-18,18,147300,147300,6527,-19927,-19927,OK
55.469,auto,Tick,291,309,-18,18,147300,146900,6527,-19927,-23527,OK
55.797,auto,Tick,292,309,-17,17,147200,146900,6512,-20112,-23512,OK
56.047,auto,Tick,292,309,-17,17,147200,147100,6512,-20112,-21812,OK
56.203,auto,Tick,292,309,-17,17,147200,147100,6512,-20112,-21812,OK
56.532,auto,Tick,292,309,-17,17,147200,147100,6512,-20112,-21812,OK
56.735,auto,Tick,292,309,-17,17,147200,147100,6512,-20112,-21812,OK
57.047,auto,Tick,292,309,-17,17,147200,147100,6512,-20112,-21812,OK
57.266,auto,Tick,292,319,-27,27,147100,147100,6806,-18406,-18406,OK
57.5,auto,Tick,292,319,-27,27,147100,146800,6806,-18406,-23806,OK
57.75,auto,Tick,292,329,-37,37,147000,146700,7100,-15000,-22400,OK
58.0,auto,Tick,292,329,-37,37,147000,146600,7100,-15000,-22400,OK
58.297,auto,Tick,292,329,-37,37,147000,146700,7100,-15000,-22400,OK
58.5,auto,Tick,292,329,-37,37,147000,146700,7100,-15000,-22400,OK
58.75,auto,Tick,292,329,-37,37,147000,146700,7100,-15000,-22400,OK
58.969,auto,Tick,292,329,-37,37,147000,146700,7100,-15000,-22400,OK
59.25,auto,Tick,292,329,-37,37,147000,146700,7100,-15000,-22400,OK
59.516,auto,Tick,292,339,-47,47,147000,146500,7394,-11294,-20694,OK
59.75,auto,Tick,292,339,-47,47,147000,146500,7394,-11294,-20694,OK
60.063,auto,Tick,292,339,-47,47,147000,146500,7394,-11294,-20694,OK
60.313,auto,Tick,292,339,-47,47,147000,146700,7394,-11294,-20694,OK
60.5,auto,Tick,302,339,-37,37,147200,146700,7688,-16588,-23988,OK
60.703,auto,Tick,302,339,-37,37,147200,146600,7688,-16588,-23988,OK
60.953,auto,Tick,302,343,-41,41,147000,146500,7806,-15106,-23306,OK
61.297,auto,Tick,302,343,-41,41,147000,146500,7806,-15106,-23306,OK
61.469,auto,Tick,302,343,-41,41,147000,146500,7806,-15106,-23306,OK
61.703,auto,Tick,302,343,-41,41,147000,146500,7806,-15106,-23306,OK
62.0,auto,Tick,302,343,-41,41,147000,146500,7806,-15106,-23306,OK
62.219,auto,Tick,302,343,-41,41,147000,146500,7806,-15106,-23306,OK
62.5,auto,Tick,302,353,-51,51,146800,146300,8100,-8400,-18600,OK
62.75,auto,Tick,312,353,-41,41,146800,146300,8394,-14694,-22894,OK
63.016,auto,Tick,312,353,-41,41,146800,146300,8394,-14694,-22894,OK
63.25,auto,Tick,312,353,-41,41,146800,146300,8394,-14694,-22894,OK
63.547,auto,Tick,312,353,-41,41,146800,146300,8394,-14694,-22894,OK
63.703,auto,Tick,312,353,-41,41,146800,146300,8394,-14694,-22894,OK
63.969,auto,Tick,312,353,-41,41,146800,146300,8394,-14694,-22894,OK
64.297,auto,Tick,322,353,-31,31,146700,146300,8688,-17988,-24188,OK
64.516,auto,Tick,322,353,-31,31,146700,146300,8688,-17988,-24188,OK
64.719,auto,Tick,322,353,-31,31,146700,146300,8688,-17988,-24188,OK
65.016,auto,Tick,322,353,-31,31,146700,146300,8688,-17988,-24188,OK
65.313,auto,Tick,322,353,-31,31,146700,146900,8688,-17988,-11788,OK
65.469,auto,Tick,322,353,-31,31,146700,146900,8688,-17988,-11788,OK
65.75,auto,Tick,322,353,-31,31,146700,146900,8688,-17988,-11788,OK
65.953,auto,Tick,332,353,-21,21,146600,146900,8541,-21841,-17641,OK
66.203,auto,Tick,332,353,-21,21,146600,146900,8541,-21841,-17641,OK
66.547,auto,Tick,332,363,-31,31,147300,146900,8394,-17694,-23894,OK
66.703,auto,Tick,332,363,-31,31,147300,146900,8394,-17694,-23894,OK
66.953,auto,Tick,342,363,-21,21,146500,146900,8247,-21547,-17347,OK
67.297,auto,Tick,342,363,-21,21,146500,146900,8247,-21547,-17347,OK
67.547,auto,Tick,352,363,-11,11,146900,146900,8100,-23400,-23400,OK
67.766,auto,Tick,362,363,-1,1,146900,146900,8394,-25694,-25694,OK
67.969,auto,Tick,362,363,-1,1,146900,146900,8394,-25694,-25694,OK
68.297,auto,Tick,362,373,-11,11,146900,146900,8247,-25547,-25547,OK
68.516,auto,Tick,372,383,-11,11,146500,146900,8394,-24694,-22494,OK
68.75,auto,Tick,372,383,-11,11,146500,147200,8394,-24694,-22494,OK
69.0,auto,Tick,372,383,-11,11,146500,147200,8394,-24694,-22494,OK
69.203,auto,Tick,372,393,-21,21,147500,147200,8247,-22547,-26747,OK
69.485,auto,Tick,372,393,-21,21,147500,147200,8247,-22547,-26747,OK
69.828,auto,Tick,372,393,-21,21,147500,147300,8247,-22547,-26747,OK
69.969,auto,Tick,372,393,-21,21,147500,147300,8247,-22547,-26747,OK
70.219,auto,Tick,372,393,-21,21,147500,147300,8247,-22547,-26747,OK
70.516,auto,Tick,372,393,-21,21,147500,147300,8247,-22547,-26747,OK
70.75,auto,Tick,382,393,-11,11,146500,147300,8100,-25400,-23200,OK
70.953,auto,Tick,382,393,-11,11,146500,147300,8100,-25400,-23200,OK
71.297,auto,Tick,382,393,-11,11,146500,147300,8100,-25400,-23200,OK
71.453,auto,Tick,382,393,-11,11,146500,147300,8100,-25400,-23200,OK
71.719,auto,Tick,382,393,-11,11,146500,147300,8100,-25400,-23200,OK
72.047,auto,Tick,382,393,-11,11,146500,147300,8100,-25400,-23200,OK
72.297,auto,Tick,382,393,-11,11,146500,147300,8100,-25400,-23200,OK
72.516,auto,Tick,382,393,-11,11,147500,147300,8100,-25400,-27600,OK
72.797,auto,Tick,382,393,-11,11,147500,147300,8100,-25400,-27600,OK
73.032,auto,Tick,382,393,-11,11,147600,147300,8100,-25400,-27600,OK
73.25,auto,Tick,382,393,-11,11,147600,147300,8100,-25400,-27600,OK
73.5,auto,Tick,382,393,-11,11,147600,147200,8100,-25400,-27600,OK
73.797,auto,Tick,382,393,-11,11,147600,147200,8100,-25400,-27600,OK
73.969,auto,Tick,392,393,-1,1,147600,147200,8395,-28695,-28895,OK
74.266,auto,Tick,392,393,-1,1,147600,147200,8395,-28695,-28895,OK
74.5,auto,Tick,392,403,-11,11,147500,147200,8690,-27990,-30190,OK
74.813,auto,Tick,392,403,-11,11,147500,147200,8690,-27990,-30190,OK
74.985,auto,Tick,392,403,-11,11,147500,147200,8690,-27990,-30190,OK
75.297,auto,Tick,392,403,-11,11,147500,147400,8690,-27990,-29090,OK
75.547,auto,Tick,392,403,-11,11,147500,147400,8690,-27990,-29090,OK
75.75,auto,Tick,392,403,-11,11,147500,147400,8690,-27990,-29090,OK
75.969,auto,Tick,392,403,-11,11,147500,147400,8690,-27990,-29090,OK
76.235,auto,Tick,392,403,-11,11,147500,147400,8690,-27990,-29090,OK
76.453,auto,Tick,392,403,-11,11,147500,147500,8690,-27990,-27990,OK
76.766,auto,Tick,402,403,-1,1,147600,147600,8985,-29285,-29285,OK
77.0,auto,Tick,402,403,-1,1,147600,147600,8985,-29285,-29285,OK
77.25,auto,Tick,402,413,-11,11,147500,147600,9280,-28580,-27480,OK
77.547,auto,Tick,402,413,-11,11,147500,147600,9280,-28580,-27480,OK
77.75,auto,Tick,412,413,-1,1,147400,147600,9133,-30433,-30233,OK
78.016,auto,Tick,412,413,-1,1,147400,147600,9133,-30433,-30233,OK
78.266,auto,Tick,412,413,-1,1,147400,147600,9133,-30433,-30233,OK
78.5,auto,Tick,422,413,9,-9,147400,147600,9428,-31728,-33528,OK
78.75,auto,Tick,422,413,9,-9,147400,147600,9428,-31728,-33528,OK
78.953,auto,Tick,422,413,9,-9,147400,147600,9428,-31728,-33528,OK
79.266,auto,Tick,432,413,19,-19,147600,147600,9723,-31823,-31823,OK
79.547,auto,Tick,432,413,19,-19,147600,147600,9723,-31823,-31823,OK
79.719,auto,Tick,442,413,29,-29,147600,148200,10018,-29118,-34918,OK
80.0,auto,Tick,452,413,39,-39,147900,148400,10314,-24414,-32214,OK
80.25,auto,Tick,462,413,49,-49,147900,148400,10610,-21710,-31510,OK
80.469,auto,Tick,472,413,59,-59,147900,148400,10906,-18006,-29806,OK
80.766,auto,Tick,472,413,59,-59,147900,148400,10906,-18006,-29806,OK
81.063,auto,Tick,472,413,59,-59,147900,148400,10906,-18006,-29806,OK
81.297,auto,Tick,472,413,59,-59,147900,148200,10906,-18006,-29806,OK
81.5,auto,Tick,472,413,59,-59,147900,148400,10906,-18006,-29806,OK
81.75,auto,Tick,472,423,49,-49,148000,148400,10758,-26858,-36658,OK
82.0,auto,Tick,482,423,59,-59,148000,148400,11054,-23154,-34954,OK
82.235,auto,Tick,482,423,59,-59,148000,148400,11054,-23154,-34954,OK
82.516,auto,Tick,492,433,59,-59,148200,148800,11202,-24302,-36102,OK
82.797,auto,Tick,492,433,59,-59,148200,148800,11202,-24302,-36102,OK
83.047,auto,Tick,492,433,59,-59,148200,148800,11202,-24302,-36102,OK
83.297,auto,Tick,492,433,59,-59,148300,148800,11202,-24302,-36102,OK
83.5,auto,Tick,492,433,59,-59,148300,148800,11202,-24302,-36102,OK
83.797,auto,Tick,492,433,59,-59,148300,148800,11202,-24302,-36102,OK
84.032,auto,Tick,492,433,59,-59,148400,149000,11202,-24302,-36102,OK
84.266,auto,Tick,492,433,59,-59,148400,149000,11202,-24302,-36102,OK
84.547,auto,Tick,492,433,59,-59,148400,149000,11202,-24302,-36102,OK
84.75,auto,Tick,492,433,59,-59,148400,149200,11202,-24302,-36102,OK
84.953,auto,Tick,502,433,69,-69,148600,149200,11499,-18599,-32399,OK
85.282,auto,Tick,502,443,59,-59,148600,149200,11796,-24896,-36696,OK
85.453,auto,Tick,502,443,59,-59,148600,149200,11796,-24896,-36696,OK
85.797,auto,Tick,502,453,49,-49,148800,149200,11647,-29747,-39547,OK
86.032,auto,Tick,512,463,49,-49,149000,149600,11796,-31896,-41696,OK
86.25,auto,Tick,512,463,49,-49,149000,149600,11796,-31896,-41696,OK
86.547,auto,Tick,512,463,49,-49,149000,149600,11796,-31896,-41696,OK
86.797,auto,Tick,512,473,39,-39,149600,149600,11647,-36747,-36747,OK
86.985,auto,Tick,512,473,39,-39,149600,149600,11647,-36747,-36747,OK
87.297,auto,Tick,512,473,39,-39,149600,149700,11647,-36747,-40647,OK
87.547,auto,Tick,512,473,39,-39,149600,149700,11647,-36747,-40647,OK
87.75,auto,Tick,512,473,39,-39,149600,149700,11647,-36747,-40647,OK
88.0,auto,Tick,512,473,39,-39,149600,149500,11647,-36747,-32847,OK
88.266,auto,Tick,512,473,39,-39,149600,149500,11647,-36747,-32847,OK
88.469,auto,Tick,512,473,39,-39,149600,149500,11647,-36747,-32847,OK
88.813,auto,Tick,512,473,39,-39,149600,149100,11647,-36747,-28947,OK
89.047,auto,Tick,512,473,39,-39,149600,149100,11647,-36747,-28947,OK
89.203,auto,Tick,512,473,39,-39,149600,149100,11647,-36747,-28947,OK
89.453,auto,Tick,512,473,39,-39,149600,148900,11647,-36747,-28947,OK
89.703,auto,Tick,512,473,39,-39,149600,148900,11647,-36747,-28947,OK
90.0,auto,Tick,512,473,39,-39,149600,148900,11647,-36747,-28947,OK
90.219,auto,Tick,512,473,39,-39,149600,148900,11647,-36747,-28947,OK
90.5,auto,Tick,512,473,39,-39,149600,149100,11647,-36747,-28947,OK
90.797,auto,Tick,512,473,39,-39,149600,149100,11647,-36747,-28947,OK
91.047,auto,Tick,512,483,29,-29,148800,149100,11498,-39598,-45398,OK
91.203,auto,Tick,512,493,19,-19,149400,149100,11797,-36897,-33097,OK
91.469,auto,Tick,512,498,14,-14,149400,149100,11946,-35046,-32246,OK
91.75,auto,Tick,512,503,9,-9,148900,148900,11872,-35972,-35972,OK
91.985,auto,Tick,512,507,5,-5,149500,148900,11992,-34492,-33492,OK
92.266,auto,Tick,522,507,15,-15,148500,148900,11843,-34343,-37343,OK
92.547,auto,Tick,522,507,15,-15,148500,148900,11843,-34343,-37343,OK
92.75,auto,Tick,522,507,15,-15,148500,148900,11843,-34343,-37343,OK
92.985,auto,Tick,522,507,15,-15,148500,148900,11843,-34343,-37343,OK
93.297,auto,Tick,522,507,15,-15,148500,149200,11843,-34343,-37343,OK
93.516,auto,Tick,522,507,15,-15,148500,149200,11843,-34343,-37343,OK
93.75,auto,Tick,522,507,15,-15,148500,149200,11843,-34343,-37343,OK
93.985,auto,Tick,522,507,15,-15,148500,149200,11843,-34343,-37343,OK
94.219,auto,Tick,522,507,15,-15,148500,149200,11843,-34343,-37343,OK
94.453,auto,Tick,522,507,15,-15,148500,149200,11843,-34343,-37343,OK
94.735,auto,Tick,522,507,15,-15,148500,149200,11843,-34343,-37343,OK
95.032,auto,Tick,522,507,15,-15,148500,149200,11843,-34343,-37343,OK
95.219,auto,Tick,522,507,15,-15,148500,149200,11843,-34343,-37343,OK
95.485,auto,Tick,522,507,15,-15,148500,149200,11843,-34343,-37343,OK
95.735,auto,Tick,522,507,15,-15,148500,149200,11843,-34343,-37343,OK
96.047,auto,Tick,522,507,15,-15,148500,149200,11843,-34343,-37343,OK
96.25,auto,Tick,522,507,15,-15,148500,149200,11843,-34343,-37343,OK
96.5,auto,Tick,522,507,15,-15,148500,149200,11843,-34343,-37343,OK
96.735,auto,Tick,528,507,21,-21,149600,149200,12023,-33923,-29723,OK
97.032,auto,Tick,528,507,21,-21,149600,149200,12023,-33923,-29723,OK
97.282,auto,Tick,528,507,21,-21,149600,149200,12023,-33923,-29723,OK
97.5,auto,Tick,538,517,21,-21,149800,149600,11724,-33624,-29424,OK
97.766,auto,Tick,538,517,21,-21,149800,149800,11724,-33624,-33624,OK
98.047,auto,Tick,538,517,21,-21,149800,149800,11724,-33624,-33624,OK
98.297,auto,Tick,538,517,21,-21,149800,149800,11724,-33624,-33624,OK
98.516,auto,Tick,548,527,21,-31,149800,149800,11424,1465676,-32324,OK
98.703,auto,Tick,548,527,21,-21,149800,149800,11424,-33324,-33324,OK
99.032,auto,Tick,548,527,21,-21,149800,149900,11424,-33324,-35424,OK
99.313,auto,Tick,548,527,21,-21,149800,150100,11424,-33324,-39624,OK
99.516,auto,Tick,558,527,31,-31,149800,150000,11724,-31624,-37824,OK
99.75,auto,Tick,558,527,31,-31,149800,150000,11724,-31624,-37824,OK
99.985,auto,Tick,558,527,31,-31,149800,150000,11724,-31624,-37824,OK
100.266,auto,Tick,558,537,21,-21,149900,149900,11574,-34474,-34474,OK
100.469,auto,Tick,558,537,21,-21,149900,149900,11574,-34474,-34474,OK
100.782,auto,Tick,558,537,21,-21,149900,149900,11574,-34474,-34474,OK
100.985,auto,Tick,558,537,21,-21,149900,149900,11574,-34474,-34474,OK
101.282,auto,Tick,568,537,31,-31,149400,149900,11424,-32324,-41624,OK
101.469,auto,Tick,568,537,31,-31,149400,150100,11424,-32324,-41624,OK
101.797,auto,Tick,568,537,31,-31,149400,150100,11424,-32324,-41624,OK
101.985,auto,Tick,568,537,31,-31,149400,150100,11424,-32324,-41624,OK
102.203,auto,Tick,568,537,31,-31,149400,150100,11424,-32324,-41624,OK
102.469,auto,Tick,568,537,31,-31,149400,150100,11424,-32324,-41624,OK
102.703,auto,Tick,578,537,41,-41,149900,150300,11724,-29624,-41924,OK
103.0,auto,Tick,578,537,41,-41,149900,150300,11724,-29624,-41924,OK
103.235,auto,Tick,578,537,41,-41,149900,150300,11724,-29624,-41924,OK
103.485,auto,Tick,582,537,45,-45,149800,150300,11664,-27564,-41064,OK
103.703,auto,Tick,582,539,43,-43,149900,150300,11634,-28534,-41434,OK
104.0,auto,Tick,582,539,43,-43,149900,150400,11634,-28534,-41434,OK
104.25,auto,Tick,582,539,43,-43,149900,150400,11634,-28534,-41434,OK
104.547,auto,Tick,582,539,43,-43,149900,150200,11634,-28534,-41434,OK
104.75,auto,Tick,582,539,43,-43,149900,150200,11634,-28534,-41434,OK
104.969,auto,Tick,582,539,43,-43,149900,150200,11634,-28534,-41434,OK
105.235,auto,Tick,582,539,43,-43,149900,150200,11634,-28534,-41434,OK
105.469,auto,Tick,582,539,43,-43,149900,150200,11634,-28534,-41434,OK
105.766,auto,Tick,582,539,43,-43,149900,150200,11634,-28534,-41434,OK
105.969,auto,Tick,582,539,43,-43,149900,150300,11634,-28534,-41434,OK
106.266,auto,Tick,582,549,33,-33,150000,150500,11484,-35384,-45284,OK
106.547,auto,Tick,592,549,43,-43,150200,150500,11334,-32234,-45134,OK
106.797,auto,Tick,592,549,43,-43,150200,150400,11334,-32234,-40834,OK
106.969,auto,Tick,592,549,43,-43,150200,150300,11334,-32234,-36534,OK
107.266,auto,Tick,592,549,43,-43,150200,150300,11334,-32234,-36534,OK
107.5,auto,Tick,592,549,43,-43,150200,150400,11334,-32234,-40834,OK
107.75,auto,Tick,592,549,43,-43,150200,150400,11334,-32234,-40834,OK
107.953,auto,Tick,592,549,43,-43,150200,150400,11334,-32234,-40834,OK
108.266,auto,Tick,592,549,43,-43,150200,150300,11334,-32234,-36534,OK
108.453,auto,Tick,592,549,43,-43,150200,150100,11334,-32234,-27934,OK
108.766,auto,Tick,592,559,33,-33,149600,150100,11634,-36534,-46434,OK
109.016,auto,Tick,592,559,33,-33,149600,150100,11634,-36534,-46434,OK
109.235,auto,Tick,592,559,33,-33,149600,150100,11634,-36534,-46434,OK
109.516,auto,Tick,592,569,23,-33,149900,150100,11484,1462616,-42984,OK
109.766,auto,Tick,592,579,13,-13,150100,150100,11784,-40684,-40684,OK
109.985,auto,Tick,592,589,3,-3,150100,150100,12084,-40984,-40984,OK
110.235,auto,Tick,592,589,3,-3,150200,150500,12084,-40984,-41884,OK
110.485,auto,Tick,602,589,13,-13,150200,150500,12384,-39284,-43184,OK
110.766,auto,Tick,612,589,23,-23,150200,150700,12684,-36584,-43484,OK
110.969,auto,Tick,622,589,33,-33,150200,150600,12984,-32884,-42784,OK
111.219,auto,Tick,632,589,43,-43,150200,150600,13284,-29184,-42084,OK
111.5,auto,Tick,642,599,43,-43,150600,150600,13434,-28334,-28334,OK
111.782,auto,Tick,642,599,43,-43,150100,150600,13434,-28334,-41234,OK
112.047,auto,Tick,642,599,43,-43,150100,150600,13434,-28334,-41234,OK
112.235,auto,Tick,642,599,43,-43,150100,150500,13434,-28334,-41234,OK
112.485,auto,Tick,642,609,33,-33,150100,150400,13734,-32634,-42534,OK
112.797,auto,Tick,642,609,33,-33,150100,150500,13734,-32634,-42534,OK
112.953,auto,Tick,642,609,33,-33,150100,150700,13734,-32634,-42534,OK
113.266,auto,Tick,642,609,33,-33,150100,150600,13734,-32634,-42534,OK
113.547,auto,Tick,642,609,33,-33,150100,150500,13734,-32634,-42534,OK
113.797,auto,Tick,642,609,33,-33,150100,150500,13734,-32634,-42534,OK
114.016,auto,Tick,642,609,33,-33,150100,150500,13734,-32634,-42534,OK
114.235,auto,Tick,642,609,33,-33,150100,150600,13734,-32634,-42534,OK
114.453,auto,Tick,642,609,33,-33,150500,150500,13734,-32634,-32634,OK
114.797,auto,Tick,642,609,33,-33,150500,150500,13734,-32634,-32634,OK
114.969,auto,Tick,642,609,33,-33,150500,150900,13734,-32634,-42534,OK
115.297,auto,Tick,652,609,43,-43,150200,150500,13584,-33484,-46384,OK
115.547,auto,Tick,652,619,33,-33,150100,150500,13884,-37384,-47284,OK
115.813,auto,Tick,652,628,24,-24,150100,150500,14154,-40354,-47554,OK
116.047,auto,Tick,652,628,24,-24,150100,150400,14154,-40354,-47554,OK
116.266,auto,Tick,652,638,14,-14,150600,150500,14004,-43204,-41804,OK
116.547,auto,Tick,652,638,14,-14,150600,150800,14004,-43204,-46004,OK
116.766,auto,Tick,652,638,14,-14,150600,150800,14004,-43204,-46004,OK
117.047,auto,Tick,662,638,24,-24,150000,150500,13854,-43054,-50254,OK
117.282,auto,Tick,662,638,24,-24,150000,150300,13854,-43054,-50254,OK
117.5,auto,Tick,662,638,24,-24,150000,150300,13854,-43054,-50254,OK
117.719,auto,Tick,662,638,24,-24,150000,150300,13854,-43054,-50254,OK
117.953,auto,Tick,662,638,24,-24,150000,150300,13854,-43054,-50254,OK
118.266,auto,Tick,662,648,14,-24,150300,150500,13704,1460096,-47704,OK
118.453,auto,Tick,662,655,7,-7,150500,150500,13915,-45115,-45115,OK
118.782,auto,Tick,662,655,7,-7,150500,150300,13915,-45115,-43715,OK
119.063,auto,Tick,672,655,17,-17,150200,150300,13765,-44965,-46665,OK
119.235,auto,Tick,682,655,27,-27,150200,150300,14065,-44265,-46965,OK
119.453,auto,Tick,682,655,27,-27,150200,150300,14065,-44265,-46965,OK
119.766,auto,Tick,682,656,26,-26,150100,150100,14050,-44450,-44450,OK
120.016,auto,Tick,682,656,26,-26,150100,150100,14050,-44450,-44450,OK
120.25,auto,Tick,682,666,16,-16,150200,150600,13900,-52300,-57100,OK
120.5,auto,Tick,682,666,16,-16,150200,150600,13900,-52300,-57100,OK
120.766,auto,Tick,682,666,16,-16,150200,150600,13900,-52300,-57100,OK
120.953,auto,Tick,682,666,16,-16,150200,150600,13900,-52300,-57100,OK
121.219,auto,Tick,692,666,26,-26,150000,150600,13750,-51150,-58950,OK
121.5,auto,Tick,702,666,36,-36,150400,150600,13600,-50000,-57200,OK
121.719,auto,Tick,702,666,36,-36,150400,150600,13600,-50000,-57200,OK
122.0,auto,Tick,712,666,46,-46,150100,150600,13450,-47850,-61650,OK
122.203,auto,Tick,712,666,46,-46,150100,150600,13450,-47850,-61650,OK
122.453,auto,Tick,712,666,46,-46,150100,150500,13450,-47850,-61650,OK
122.735,auto,Tick,712,666,46,-46,150100,150500,13450,-47850,-61650,OK
123.032,auto,Tick,712,666,46,-46,150100,150500,13450,-47850,-61650,OK
123.266,auto,Tick,712,666,46,-46,150100,150400,13450,-47850,-61650,OK
123.485,auto,Tick,712,666,46,-46,150100,150400,13450,-47850,-61650,OK
123.75,auto,Tick,712,676,36,-36,150400,150400,13300,-51700,-51700,OK
123.985,auto,Tick,712,686,26,-26,150400,150400,13150,-54550,-54550,OK
124.25,auto,Tick,712,696,16,-16,150400,150400,13451,-55851,-55851,OK
124.563,auto,Tick,712,706,6,-6,150400,150400,13752,-57152,-57152,OK
124.703,auto,Tick,712,706,6,-6,150400,150400,13752,-57152,-57152,OK
124.985,auto,Tick,712,706,6,-6,150400,150400,13752,-57152,-57152,OK
125.25,auto,Tick,712,706,6,-6,150400,150400,13752,-57152,-57152,OK
125.547,auto,Tick,712,706,6,-6,150400,150400,13752,-57152,-57152,OK
125.75,auto,Tick,712,706,6,-6,150400,150400,13752,-57152,-57152,OK
126.0,auto,Tick,722,706,16,-16,150500,150700,14053,-57453,-60653,OK
126.282,auto,Tick,732,706,26,-26,150500,151200,14354,-56754,-64554,OK
126.453,auto,Tick,742,706,36,-36,150500,151200,14655,-51055,-61855,OK
126.766,auto,Tick,752,706,46,-46,150500,151000,14956,-46356,-60156,OK
126.969,auto,Tick,752,716,36,-36,150500,151000,15257,-50657,-61457,OK
127.282,auto,Tick,752,716,36,-36,150500,151000,15257,-50657,-61457,OK
127.469,auto,Tick,752,716,36,-36,150500,150700,15257,-50657,-57857,OK
127.813,auto,Tick,752,726,26,-26,150400,150400,15558,-52958,-52958,OK
128.063,auto,Tick,752,736,16,-16,150400,150300,15859,-53259,-51659,OK
128.203,auto,Tick,752,736,16,-16,150400,150300,15859,-53259,-51659,OK
128.532,auto,Tick,752,736,16,-16,150400,150200,15859,-53259,-50059,OK
128.75,auto,Tick,752,736,16,-16,150400,150200,15859,-53259,-50059,OK
129.0,auto,Tick,752,736,16,-16,150400,150200,15859,-53259,-50059,OK
129.25,auto,Tick,752,736,16,-16,150400,150200,15859,-53259,-50059,OK
129.485,auto,Tick,752,746,6,-6,150900,150400,15709,-55109,-53309,OK
129.735,auto,Tick,752,746,6,-6,150900,150400,15709,-55109,-53309,OK
129.985,auto,Tick,752,746,6,-6,150900,150400,15709,-55109,-53309,OK
130.297,auto,Tick,752,746,6,-6,150900,150400,15709,-55109,-53309,OK
130.485,auto,Tick,752,746,6,-6,150900,150400,15709,-55109,-53309,OK
130.735,auto,Tick,752,746,6,-6,150900,150400,15709,-55109,-53309,OK
131.0,auto,Tick,752,746,6,-6,150900,150400,15709,-55109,-53309,OK
131.219,auto,Tick,762,746,16,-16,149800,150100,15559,-54959,-59759,OK
131.469,auto,Tick,762,746,16,-16,149800,150100,15559,-54959,-59759,OK
131.813,auto,Tick,762,746,16,-16,149800,150100,15559,-54959,-59759,OK
131.985,auto,Tick,762,756,6,-6,150800,150100,15409,-55809,-54009,OK
132.282,auto,Tick,762,756,6,-6,150800,149800,15409,-55809,-54009,OK
132.5,auto,Tick,762,756,6,-6,150800,149800,15409,-55809,-54009,OK
132.797,auto,Tick,762,766,-4,4,149800,149600,15709,-55109,-55909,OK
133.0,auto,Tick,762,776,-14,14,149800,149600,16009,-53409,-56209,OK
133.219,auto,Tick,762,786,-24,24,150200,149600,15859,-51259,-56059,OK
133.485,auto,Tick,762,786,-24,24,150200,149600,15859,-51259,-56059,OK
133.766,auto,Tick,772,786,-14,14,149300,149500,15709,-54109,-51309,OK
134.047,auto,Tick,772,786,-14,14,149300,149600,15709,-54109,-51309,OK
134.235,auto,Tick,772,786,-14,14,149300,149600,15709,-54109,-51309,OK
134.516,auto,Tick,772,786,-14,14,149300,149700,15709,-54109,-51309,OK
134.75,auto,Tick,772,786,-14,14,149300,149700,15709,-54109,-51309,OK
135.0,auto,Tick,772,786,-14,14,149300,149800,15709,-54109,-49909,OK
135.235,auto,Tick,782,786,-4,4,149200,149800,15559,-56959,-55759,OK
135.532,auto,Tick,792,788,4,-4,149800,149900,15379,-56579,-56979,OK
135.766,auto,Tick,792,788,4,-4,149300,149900,15379,-56579,-57779,OK
136.047,auto,Tick,792,788,4,-4,149300,149900,15379,-56579,-57779,OK
136.282,auto,Tick,792,788,4,-4,149300,149900,15379,-56579,-57779,OK
136.453,auto,Tick,792,788,4,-4,149300,149900,15379,-56579,-57779,OK
136.782,auto,Tick,792,788,4,-4,149300,149800,15379,-56579,-57779,OK
137.016,auto,Tick,792,788,4,-4,149300,149600,15379,-56579,-57379,OK
137.25,auto,Tick,792,788,4,-4,149300,149600,15379,-56579,-57379,OK
137.547,auto,Tick,792,788,4,-4,149300,149600,15379,-56579,-57379,OK
137.719,auto,Tick,792,788,4,-4,149300,149300,15379,-56579,-56579,OK
138.047,auto,Tick,792,788,4,-4,149300,149300,15379,-56579,-56579,OK
138.25,auto,Tick,792,788,4,-4,149300,149300,15379,-56579,-56579,OK
138.516,auto,Tick,792,788,4,-4,149300,149300,15379,-56579,-56579,OK
138.75,auto,Tick,792,788,4,-4,149300,149100,15379,-56579,-55779,OK
139.0,auto,Tick,792,788,4,-4,149300,149100,15379,-56579,-55779,OK
139.282,auto,Tick,792,788,4,-4,149300,149100,15379,-56579,-55779,OK
139.5,auto,Tick,792,788,4,-4,149300,149300,15379,-56579,-56579,OK
139.782,auto,Tick,792,788,4,-4,149300,149300,15379,-56579,-56579,OK
140.0,auto,Tick,792,788,4,-4,149300,149300,15379,-56579,-56579,OK
140.266,auto,Tick,792,788,4,-4,149300,149300,15379,-56579,-56579,OK
140.485,auto,Tick,792,795,-3,3,149800,149300,15274,-56474,-57074,OK
140.75,auto,Tick,792,795,-3,3,149800,149300,15274,-56474,-57074,OK
141.047,auto,Tick,792,795,-3,3,149800,149300,15274,-56474,-57074,OK
141.219,auto,Tick,792,795,-3,3,149800,149300,15274,-56474,-57074,OK
141.485,auto,Tick,792,795,-3,3,149800,149300,15274,-56474,-57074,OK
141.782,auto,Tick,792,805,-13,13,150200,149500,15124,-55324,-57924,OK
142.047,auto,Tick,792,805,-13,13,150200,149500,15124,-55324,-57924,OK
142.297,auto,Tick,792,805,-13,13,150200,149500,15124,-55324,-57924,OK
142.5,auto,Tick,792,805,-13,13,150200,149500,15124,-55324,-57924,OK
142.797,auto,Tick,792,815,-23,23,150200,149500,14974,-53174,-57774,OK
142.953,auto,Tick,792,815,-23,23,150200,149500,14974,-53174,-57774,OK
143.297,auto,Tick,792,815,-23,23,150200,149500,14974,-53174,-57774,OK
143.453,auto,Tick,792,815,-23,23,150200,149500,14974,-53174,-57774,OK
143.766,auto,Tick,792,825,-33,33,150200,149700,14824,-51024,-57624,OK
144.016,auto,Tick,802,825,-23,23,149200,149700,14674,-54874,-50274,OK
144.297,auto,Tick,802,825,-23,23,149200,149700,14674,-54874,-50274,OK
144.5,auto,Tick,812,825,-13,13,149100,149700,14524,-57724,-55124,OK
144.75,auto,Tick,812,825,-13,13,149100,149700,14524,-57724,-55124,OK
144.969,auto,Tick,812,825,-13,13,149100,149700,14524,-57724,-55124,OK
145.235,auto,Tick,812,825,-13,13,149100,149700,14524,-57724,-55124,OK
145.563,auto,Tick,812,825,-13,13,149100,149700,14524,-57724,-55124,OK
145.797,auto,Tick,812,825,-13,13,149100,149700,14524,-57724,-55124,OK
146.016,auto,Tick,812,825,-13,13,149100,149700,14524,-57724,-55124,OK
146.25,auto,Tick,812,825,-13,13,149100,149700,14524,-57724,-55124,OK
146.516,auto,Tick,812,825,-13,13,149100,149500,14524,-57724,-55124,OK
146.75,auto,Tick,812,825,-13,13,149100,149700,14524,-57724,-55124,OK
146.969,auto,Tick,812,825,-13,13,149100,149700,14524,-57724,-55124,OK
147.25,auto,Tick,812,825,-13,13,149100,149700,14524,-57724,-55124,OK
147.469,auto,Tick,812,825,-13,13,149100,149600,14524,-57724,-55124,OK
147.782,auto,Tick,812,825,-13,13,149100,149600,14524,-57724,-55124,OK
148.047,auto,Tick,812,825,-13,13,149100,149600,14524,-57724,-55124,OK
148.266,auto,Tick,812,825,-13,13,149100,149600,14524,-57724,-55124,OK
148.5,auto,Tick,812,825,-13,13,149100,149600,14524,-57724,-55124,OK
148.719,auto,Tick,812,825,-13,13,149100,149600,14524,-57724,-55124,OK
149.047,auto,Tick,812,825,-13,13,149100,149600,14524,-57724,-55124,OK
149.235,auto,Tick,812,825,-13,13,149100,149600,14524,-57724,-55124,OK
149.453,auto,Tick,812,825,-13,13,149100,150100,14524,-57724,-53824,OK
149.735,auto,Tick,812,835,-23,23,150600,150100,14374,-51574,-58474,OK
150.0,auto,Tick,812,835,-23,23,150600,150100,14374,-51574,-58474,OK
150.313,auto,Tick,812,835,-23,23,150600,150100,14374,-51574,-58474,OK
150.453,auto,Tick,812,835,-23,23,150600,150100,14374,-51574,-58474,OK
150.782,auto,Tick,812,835,-23,23,150600,150100,14374,-51574,-58474,OK
151.0,auto,Tick,812,835,-23,23,150600,150100,14374,-51574,-58474,OK
151.266,auto,Tick,812,835,-23,23,150600,150100,14374,-51574,-58474,OK
151.485,auto,Tick,812,835,-23,23,150600,150100,14374,-51574,-58474,OK
151.703,auto,Tick,812,835,-23,23,150600,150100,14374,-51574,-58474,OK
152.032,auto,Tick,812,835,-23,23,150600,150100,14374,-51574,-58474,OK
152.219,auto,Tick,812,835,-23,23,150600,150100,14374,-51574,-58474,OK
152.5,auto,Tick,812,835,-23,23,150600,150100,14374,-51574,-58474,OK
152.703,auto,Tick,812,835,-23,23,150600,150100,14374,-51574,-58474,OK
153.047,auto,Tick,812,845,-33,33,150400,150100,14224,-48424,-58324,OK
153.266,auto,Tick,812,845,-33,33,150400,149800,14224,-48424,-58324,OK
153.453,auto,Tick,812,845,-33,33,150400,149800,14224,-48424,-58324,OK
153.782,auto,Tick,812,845,-33,33,150400,150100,14224,-48424,-58324,OK
154.0,auto,Tick,812,845,-33,33,150400,150100,14224,-48424,-58324,OK
154.266,auto,Tick,812,845,-33,33,150400,150100,14224,-48424,-58324,OK
154.5,auto,Tick,812,845,-33,33,150400,150100,14224,-48424,-58324,OK
154.719,auto,Tick,812,845,-33,33,150400,150100,14224,-48424,-58324,OK
154.985,auto,Tick,822,845,-23,23,150600,150100,14525,-51725,-58625,OK
155.25,auto,Tick,832,845,-13,13,150600,150100,14826,-55026,-58926,OK
155.5,auto,Tick,832,845,-13,13,150600,150300,14826,-55026,-58926,OK
155.75,auto,Tick,832,845,-13,13,150600,150300,14826,-55026,-58926,OK
155.953,auto,Tick,832,845,-13,13,150600,150300,14826,-55026,-58926,OK
156.25,auto,Tick,832,845,-13,13,150600,150300,14826,-55026,-58926,OK
156.469,auto,Tick,832,845,-13,13,150600,150300,14826,-55026,-58926,OK
156.782,auto,Tick,832,845,-13,13,150600,150300,14826,-55026,-58926,OK
157.016,auto,Tick,832,845,-13,13,150600,150300,14826,-55026,-58926,OK
157.25,auto,Tick,832,855,-23,23,150600,150300,14676,-52876,-59776,OK
157.547,auto,Tick,832,855,-23,23,150600,150300,14676,-52876,-59776,OK
157.75,auto,Tick,832,855,-23,23,150600,150300,14676,-52876,-59776,OK
157.953,auto,Tick,832,855,-23,23,150600,150300,14676,-52876,-59776,OK
158.235,auto,Tick,842,855,-13,13,150600,150300,14977,-56177,-60077,OK
158.516,auto,Tick,842,855,-13,13,150500,150300,14977,-56177,-58777,OK
158.766,auto,Tick,842,855,-13,13,150500,150300,14977,-56177,-58777,OK
158.985,auto,Tick,852,855,-3,3,150600,150400,15278,-58478,-59078,OK
159.219,auto,Tick,852,855,-3,3,150600,150400,15278,-58478,-59078,OK
159.547,auto,Tick,852,865,-13,13,150500,150400,15579,-57779,-59079,OK
159.703,auto,Tick,861,865,-4,4,150600,150400,15850,-59850,-60650,OK
159.985,auto,Tick,861,865,-4,4,150600,150400,15850,-59850,-60650,OK
160.203,auto,Tick,861,867,-6,4,150700,150400,15820,241580,-61020,OK
160.532,auto,Tick,861,873,-12,12,150600,150400,15730,-58130,-60530,OK
160.813,auto,Tick,861,873,-12,12,150600,150200,15730,-58130,-61730,OK
161.047,auto,Tick,861,881,-20,20,150500,150200,15971,-56771,-62771,OK
161.203,auto,Tick,861,881,-20,20,150500,150200,15971,-56771,-62771,OK
161.453,auto,Tick,861,881,-20,20,150500,150200,15971,-56771,-62771,OK
161.766,auto,Tick,861,881,-20,20,150500,150200,15971,-56771,-62771,OK
162.047,auto,Tick,861,881,-20,20,150500,150200,15971,-56771,-62771,OK
162.266,auto,Tick,861,881,-20,20,150800,150800,15971,-56771,-56771,OK
162.453,auto,Tick,864,881,-17,17,150900,150800,16062,-57462,-59162,OK
162.782,auto,Tick,864,881,-17,17,150900,150700,16062,-57462,-60862,OK
163.047,auto,Tick,864,881,-17,17,150900,150700,16062,-57462,-60862,OK
163.25,auto,Tick,864,881,-17,17,150900,150600,16062,-57462,-62562,OK
163.469,auto,Tick,875,881,-6,6,150700,150800,15941,-58341,-57741,OK
163.75,auto,Tick,875,881,-6,6,150700,150800,15941,-58341,-57741,OK
163.953,auto,Tick,875,881,-6,6,150700,150800,15941,-58341,-57741,OK
164.219,auto,Tick,885,881,4,-4,151000,151000,16243,-59643,-59643,OK
164.485,auto,Tick,885,881,4,-4,151000,151000,16243,-59643,-59643,OK
164.766,auto,Tick,885,891,-6,6,151000,150900,16092,-60492,-61092,OK
165.032,auto,Tick,885,891,-6,6,151000,151000,16092,-60492,-60492,OK
165.266,auto,Tick,895,891,4,-4,151000,151000,16394,-61794,-61794,OK
165.453,auto,Tick,895,901,-6,6,151400,151000,16243,-59643,-61443,OK
165.75,auto,Tick,895,901,-6,6,151400,151000,16243,-59643,-61443,OK
165.953,auto,Tick,895,901,-6,6,151400,151000,16243,-59643,-61443,OK
166.219,auto,Tick,895,906,-11,6,151300,151100,16167,696933,-60767,OK
166.485,auto,Tick,895,906,-11,11,151300,151100,16167,-58567,-60767,OK
166.75,auto,Tick,895,906,-11,11,151300,151100,16167,-58567,-60767,OK
167.047,auto,Tick,895,906,-11,11,151300,151100,16167,-58567,-60767,OK
167.25,auto,Tick,895,906,-11,11,151300,151100,16167,-58567,-60767,OK
167.485,auto,Tick,895,906,-11,11,151300,151100,16167,-58567,-60767,OK
167.75,auto,Tick,905,906,-1,1,151400,151100,16470,-60870,-61170,OK
168.0,auto,Tick,905,906,-1,1,151500,151100,16470,-60870,-61170,OK
168.282,auto,Tick,905,906,-1,1,151500,151100,16470,-60870,-61170,OK
168.453,auto,Tick,905,906,-1,1,151500,151100,16470,-60870,-61170,OK
168.797,auto,Tick,905,906,-1,1,151500,151100,16470,-60870,-61170,OK
168.969,auto,Tick,905,906,-1,1,151500,151100,16470,-60870,-61170,OK
169.219,auto,Tick,905,916,-11,11,151100,150500,16319,-59719,-63019,OK
169.547,auto,Tick,905,916,-11,11,151100,150500,16319,-59719,-63019,OK
169.719,auto,Tick,905,916,-11,11,151100,150800,16319,-59719,-63019,OK
170.0,auto,Tick,905,916,-11,11,151100,150700,16319,-59719,-63019,OK
170.203,auto,Tick,905,916,-11,11,151100,150700,16319,-59719,-63019,OK
170.516,auto,Tick,905,916,-11,11,151100,150700,16319,-59719,-63019,OK
170.735,auto,Tick,905,916,-11,11,151100,150500,16319,-59719,-63019,OK
171.016,auto,Tick,905,916,-11,11,151100,150500,16319,-59719,-63019,OK
171.297,auto,Tick,905,916,-11,11,151100,150500,16319,-59719,-63019,OK
171.516,auto,Tick,909,916,-7,11,150600,150500,16259,-662059,-60759,OK
171.766,auto,Tick,915,916,-1,7,150400,150500,16169,-963569,-60469,OK
172.047,auto,Tick,915,926,-11,11,151200,150500,16018,-59418,-62718,OK
172.297,auto,Tick,915,926,-11,11,151200,150500,16018,-59418,-62718,OK
172.485,auto,Tick,915,926,-11,11,151200,150500,16018,-59418,-62718,OK
172.75,auto,Tick,915,936,-21,21,151000,150500,15867,-57267,-63567,OK
172.953,auto,Tick,915,936,-21,21,151000,150500,15867,-57267,-63567,OK
173.266,auto,Tick,915,936,-21,21,151000,150500,15867,-57267,-63567,OK
173.516,auto,Tick,915,936,-21,21,151000,150500,15867,-57267,-63567,OK
173.766,auto,Tick,915,936,-21,21,151000,150500,15867,-57267,-63567,OK
174.0,auto,Tick,915,936,-21,21,151000,150500,15867,-57267,-63567,OK
174.297,auto,Tick,915,936,-21,21,151000,150500,15867,-57267,-63567,OK
174.469,auto,Tick,915,936,-21,21,151000,150500,15867,-57267,-63567,OK
174.782,auto,Tick,915,936,-21,21,151000,150600,15867,-57267,-63567,OK
175.063,auto,Tick,925,936,-11,11,150800,150600,16169,-59569,-61769,OK
175.266,auto,Tick,935,936,-1,1,150800,150600,16471,-61871,-62071,OK
175.532,auto,Tick,935,936,-1,1,150800,150600,16471,-61871,-62071,OK
175.703,auto,Tick,935,936,-1,1,150800,150600,16471,-61871,-62071,OK
176.0,auto,Tick,935,936,-1,1,150800,150600,16471,-61871,-62071,OK
176.219,auto,Tick,935,936,-1,1,150800,150600,16471,-61871,-62071,OK
176.516,auto,Tick,945,936,9,-9,150700,150600,16320,-62720,-61820,OK
176.797,auto,Tick,945,936,9,-9,150700,150600,16320,-62720,-61820,OK
177.0,auto,Tick,945,936,9,-9,150700,150600,16320,-62720,-61820,OK
177.25,auto,Tick,945,936,9,-9,150700,150600,16320,-62720,-61820,OK
177.563,auto,Tick,945,946,-1,1,151200,150600,16169,-62569,-62869,OK
177.797,auto,Tick,945,946,-1,1,151200,150300,16169,-62569,-62869,OK
178.032,auto,Tick,945,946,-1,1,151200,150300,16169,-62569,-62869,OK
178.297,auto,Tick,945,946,-1,1,151200,150300,16169,-62569,-62869,OK
178.469,auto,Tick,945,946,-1,1,151200,150200,16169,-62569,-62869,OK
178.703,auto,Tick,945,956,-11,11,150400,150200,16470,-60870,-63070,OK
179.047,auto,Tick,945,966,-21,21,150400,150200,16771,-59171,-63371,OK
179.282,auto,Tick,945,966,-21,21,150400,150200,16771,-59171,-63371,OK
179.469,auto,Tick,945,966,-21,21,150400,149900,16771,-59171,-65471,OK
179.813,auto,Tick,945,966,-21,21,150400,149900,16771,-59171,-65471,OK
180.047,auto,Tick,945,976,-31,21,150400,149800,16621,1442979,-64321,OK
180.266,auto,Tick,954,976,-22,22,150100,149800,16486,-59486,-66086,OK
180.547,auto,Tick,954,976,-22,22,150100,149800,16486,-59486,-66086,OK
180.719,auto,Tick,954,976,-22,22,150100,149900,16486,-59486,-63886,OK
181.0,auto,Tick,954,976,-22,22,150100,149900,16486,-59486,-63886,OK
181.203,auto,Tick,954,976,-22,22,150100,149900,16486,-59486,-63886,OK
181.516,auto,Tick,964,976,-12,12,149700,149900,16336,-63336,-60936,OK
181.703,auto,Tick,964,976,-12,12,149700,149900,16336,-63336,-60936,OK
182.0,auto,Tick,964,976,-12,12,149700,149900,16336,-63336,-60936,OK
182.266,auto,Tick,964,976,-12,12,149700,149900,16336,-63336,-60936,OK
182.485,auto,Tick,964,976,-12,12,149700,149900,16336,-63336,-60936,OK
182.797,auto,Tick,964,976,-12,12,149700,149900,16336,-63336,-60936,OK
183.0,auto,Tick,964,976,-12,12,149700,149900,16336,-63336,-60936,OK
183.297,auto,Tick,964,976,-12,12,149700,149900,16336,-63336,-60936,OK
183.485,auto,Tick,964,976,-12,12,149700,150000,16336,-63336,-59736,OK
183.703,auto,Tick,974,976,-2,2,150100,150000,16186,-65186,-65386,OK
184.0,auto,Tick,977,976,1,-1,150100,150000,16141,-65441,-65341,OK
184.266,auto,Tick,977,976,1,-1,150100,149700,16141,-65441,-65241,OK
184.516,auto,Tick,987,976,11,-1,149700,149700,15991,-1562291,-65291,OK
184.782,auto,Tick,997,976,21,-21,149700,149700,16290,-63590,-63590,OK
185.0,auto,Tick,997,976,21,-21,149700,150000,16290,-63590,-69890,OK
185.25,auto,Tick,997,976,21,-21,149700,150000,16290,-63590,-69890,OK
185.469,auto,Tick,997,976,21,-21,149700,150000,16290,-63590,-69890,OK
185.766,auto,Tick,997,976,21,-21,149700,150000,16290,-63590,-69890,OK
186.047,auto,Tick,997,976,21,-21,149700,150000,16290,-63590,-69890,OK
186.25,auto,Tick,997,976,21,-21,149700,149800,16290,-63590,-65690,OK
186.516,auto,Tick,997,986,11,-11,149600,149800,16589,-65889,-68089,OK
186.75,auto,Tick,997,986,11,-11,149600,149800,16589,-65889,-68089,OK
187.0,auto,Tick,1007,986,21,-21,149700,149800,16888,-65188,-67288,OK
187.203,auto,Tick,1007,986,21,-21,149700,149800,16888,-65188,-67288,OK
187.547,auto,Tick,1007,986,21,-21,149700,150000,16888,-65188,-71488,OK
187.797,auto,Tick,1017,986,31,-31,149700,150000,17187,-62487,-71787,OK
187.953,auto,Tick,1027,986,41,-41,149700,150000,17486,-59786,-72086,OK
188.297,auto,Tick,1033,986,47,-47,149700,150100,17396,-56096,-70196,OK
188.547,auto,Tick,1033,996,37,-37,149700,150100,17246,-62946,-74046,OK
188.75,auto,Tick,1033,996,37,-37,149700,150100,17246,-62946,-74046,OK
188.985,auto,Tick,1033,996,37,-37,149700,150200,17246,-62946,-74046,OK
189.266,auto,Tick,1033,996,37,-37,149700,150200,17246,-62946,-74046,OK
189.547,auto,Tick,1043,996,47,-47,150100,150200,17096,-60796,-65496,OK
189.797,auto,Tick,1043,996,47,-47,150100,150200,17096,-60796,-65496,OK
190.0,auto,Tick,1053,996,57,-57,150000,150200,17396,-58096,-69496,OK
190.203,auto,Tick,1053,996,57,-57,150000,150300,17396,-58096,-75196,OK
190.547,auto,Tick,1053,996,57,-57,150000,150300,17396,-58096,-75196,OK
190.797,auto,Tick,1053,996,57,-57,150000,150300,17396,-58096,-75196,OK
191.063,auto,Tick,1053,996,57,-57,149500,150300,17396,-58096,-75196,OK
191.266,auto,Tick,1053,996,57,-57,149500,150400,17396,-58096,-75196,OK
191.485,auto,Tick,1063,996,67,-67,150000,150700,17696,-52396,-72496,OK
191.797,auto,Tick,1063,996,67,-67,150000,150800,17696,-52396,-72496,OK
192.047,auto,Tick,1063,1006,57,-57,150200,150800,17996,-58696,-75796,OK
192.297,auto,Tick,1063,1006,57,-57,150200,150700,17996,-58696,-75796,OK
192.5,auto,Tick,1063,1006,57,-57,150200,150700,17996,-58696,-75796,OK
192.735,auto,Tick,1063,1006,57,-57,150300,150700,17996,-58696,-75796,OK
193.047,auto,Tick,1073,1006,67,-67,150200,150500,17846,-55546,-75646,OK
193.313,auto,Tick,1073,1016,57,-57,150200,150500,18146,-60846,-77946,OK
193.5,auto,Tick,1073,1026,47,-47,150000,150500,18446,-66146,-80246,OK
193.735,auto,Tick,1073,1026,47,-47,150000,150500,18446,-66146,-80246,OK
193.969,auto,Tick,1073,1026,47,-47,150000,150500,18446,-66146,-80246,OK
194.219,auto,Tick,1073,1026,47,-47,150000,150500,18446,-66146,-80246,OK
194.547,auto,Tick,1073,1026,47,-47,150000,150500,18446,-66146,-80246,OK
194.797,auto,Tick,1073,1026,47,-47,150000,150500,18446,-66146,-80246,OK
194.969,auto,Tick,1073,1026,47,-47,150000,150600,18446,-66146,-80246,OK
195.235,auto,Tick,1073,1026,47,-47,150000,150600,18446,-66146,-80246,OK
195.516,auto,Tick,1073,1026,47,-47,150000,150600,18446,-66146,-80246,OK
195.766,auto,Tick,1073,1026,47,-47,150000,150600,18446,-66146,-80246,OK
196.047,auto,Tick,1073,1026,47,-47,150000,150600,18446,-66146,-80246,OK
196.297,auto,Tick,1083,1026,57,-47,149800,150600,18296,-1563996,-75096,OK
196.532,auto,Tick,1083,1026,57,-57,149800,150600,18296,-61996,-79096,OK
196.735,auto,Tick,1083,1026,57,-57,149800,150100,18296,-61996,-79096,OK
196.969,auto,Tick,1083,1026,57,-57,149800,150000,18296,-61996,-73396,OK
197.266,auto,Tick,1083,1036,47,-47,149500,150000,18595,-67295,-81395,OK
197.547,auto,Tick,1083,1046,37,-37,149500,150000,18894,-71594,-82694,OK
197.735,auto,Tick,1083,1046,37,-37,149500,149800,18894,-71594,-82694,OK
198.016,auto,Tick,1083,1046,37,-37,149500,149700,18894,-71594,-78994,OK
198.25,auto,Tick,1083,1056,27,-27,149500,149700,19193,-74893,-80293,OK
198.516,auto,Tick,1083,1066,17,-17,149500,149500,19492,-77192,-77192,OK
198.735,auto,Tick,1083,1076,7,-7,149500,149500,19791,-79491,-79491,OK
199.0,auto,Tick,1083,1076,7,-7,149500,149500,19791,-79491,-79491,OK
199.282,auto,Tick,1083,1076,7,-7,149500,149500,19791,-79491,-79491,OK
199.485,auto,Tick,1083,1076,7,-7,149500,149500,19791,-79491,-79491,OK
199.75,auto,Tick,1083,1076,7,-7,149500,149500,19791,-79491,-79491,OK
200.0,auto,Tick,1083,1076,7,-7,149500,149500,19791,-79491,-79491,OK
200.266,auto,Tick,1083,1076,7,-7,149500,149600,19791,-79491,-80191,OK
200.469,auto,Tick,1083,1080,3,-3,149700,149600,19731,-79431,-79131,OK
200.719,auto,Tick,1083,1080,3,-3,149700,149600,19731,-79431,-79131,OK
201.016,auto,Tick,1083,1080,3,-3,149700,149600,19731,-79431,-79131,OK
201.203,auto,Tick,1083,1090,-7,-3,149900,149600,19581,1418719,-78681,OK
201.516,auto,Tick,1083,1090,-7,7,149900,149800,19581,-79281,-79981,OK
201.813,auto,Tick,1093,1090,3,-3,149300,150000,19836,-80336,-81236,OK
202.016,auto,Tick,1093,1090,3,-3,149300,150000,19836,-80336,-81236,OK
202.266,auto,Tick,1093,1090,3,-3,149300,150200,19836,-80336,-81236,OK
202.547,auto,Tick,1093,1090,3,-3,149300,150200,19836,-80336,-81236,OK
202.797,auto,Tick,1103,1090,13,-13,150500,150600,20137,-80637,-81937,OK
203.0,auto,Tick,1113,1090,23,-23,150500,150600,20438,-79938,-82238,OK
203.25,auto,Tick,1113,1090,23,-23,150500,150600,20438,-79938,-82238,OK
203.5,auto,Tick,1113,1090,23,-23,150500,150600,20438,-79938,-82238,OK
203.735,auto,Tick,1113,1090,23,-23,150500,150600,20438,-79938,-82238,OK
204.016,auto,Tick,1123,1090,33,-23,150200,150600,20288,-1581788,-85688,OK
204.203,auto,Tick,1123,1090,33,-33,150200,150600,20288,-77788,-87688,OK
204.516,auto,Tick,1123,1090,33,-33,150200,150600,20288,-77788,-87688,OK
204.797,auto,Tick,1123,1090,33,-33,150200,150600,20288,-77788,-87688,OK
204.969,auto,Tick,1132,1090,42,-42,149800,150100,20153,-75853,-88453,OK
205.266,auto,Tick,1132,1100,32,-32,149700,149700,20452,-78152,-78152,OK
205.547,auto,Tick,1132,1110,22,-22,150400,149700,20302,-80002,-75602,OK
205.703,auto,Tick,1132,1110,22,-22,150400,149700,20302,-80002,-75602,OK
206.063,auto,Tick,1132,1110,22,-22,150400,149800,20302,-80002,-73402,OK
206.282,auto,Tick,1132,1130,2,-2,149700,149800,20451,-85151,-85351,OK
206.5,auto,Tick,1132,1130,2,-2,149700,149800,20451,-85151,-85351,OK
206.797,auto,Tick,1132,1130,2,-2,149700,149800,20451,-85151,-85351,OK
207.0,auto,Tick,1132,1130,2,-2,149700,149800,20451,-85151,-85351,OK
207.313,auto,Tick,1132,1130,2,-2,149700,149800,20451,-85151,-85351,OK
207.453,auto,Tick,1132,1130,2,-2,149700,149800,20451,-85151,-85351,OK
207.797,auto,Tick,1132,1130,2,-2,149700,149800,20451,-85151,-85351,OK
207.985,auto,Tick,1132,1130,2,-2,149700,149800,20451,-85151,-85351,OK
208.25,auto,Tick,1142,1130,12,-12,149200,149800,20301,-85001,-88601,OK
208.532,auto,Tick,1142,1140,2,-2,149800,149800,20151,-85851,-85851,OK
208.735,auto,Tick,1142,1140,2,-2,149800,149800,20151,-85851,-85851,OK
208.969,auto,Tick,1142,1140,2,-2,149800,149800,20151,-85851,-85851,OK
209.266,auto,Tick,1142,1140,2,-2,149800,149800,20151,-85851,-85851,OK
209.469,auto,Tick,1142,1140,2,-2,149800,149800,20151,-85851,-85851,OK
209.735,auto,Tick,1142,1150,-8,8,150300,149800,20001,-85701,-88101,OK
210.016,auto,Tick,1142,1150,-8,8,150300,149800,20001,-85701,-88101,OK
210.297,auto,Tick,1142,1150,-8,8,150300,149800,20001,-85701,-88101,OK
210.453,auto,Tick,1142,1150,-8,8,150300,149800,20001,-85701,-88101,OK
210.75,auto,Tick,1142,1150,-8,8,150300,149800,20001,-85701,-88101,OK
210.969,auto,Tick,1142,1160,-18,18,150400,149900,19851,-84551,-89951,OK
211.297,auto,Tick,1142,1169,-27,27,150200,149900,20121,-82121,-90221,OK
211.5,auto,Tick,1142,1169,-27,27,150200,149900,20121,-82121,-90221,OK
211.735,auto,Tick,1152,1169,-17,17,149900,149600,19971,-87971,-91371,OK
211.953,auto,Tick,1162,1169,-7,7,149100,149600,19821,-89821,-88421,OK
212.25,auto,Tick,1162,1169,-7,7,149100,149700,19821,-89821,-88421,OK
212.485,auto,Tick,1162,1169,-7,7,149100,149700,19821,-89821,-88421,OK
212.75,auto,Tick,1162,1179,-17,17,150200,149700,19671,-88671,-92071,OK
213.016,auto,Tick,1162,1179,-17,17,150200,149700,19671,-88671,-92071,OK
213.25,auto,Tick,1162,1179,-17,17,150200,149300,19671,-88671,-92071,OK
213.547,auto,Tick,1162,1179,-17,17,150200,149300,19671,-88671,-92071,OK
213.766,auto,Tick,1162,1179,-17,17,150200,149300,19671,-88671,-92071,OK
213.953,auto,Tick,1162,1179,-17,17,150200,149300,19671,-88671,-92071,OK
214.297,auto,Tick,1162,1179,-17,17,150200,149300,19671,-88671,-92071,OK
214.5,auto,Tick,1162,1179,-17,17,150200,149300,19671,-88671,-92071,OK
214.813,auto,Tick,1162,1179,-17,17,150200,149600,19671,-88671,-92071,OK
214.953,auto,Tick,1162,1179,-17,17,150200,149600,19671,-88671,-92071,OK
215.266,auto,Tick,1162,1179,-17,17,150200,149600,19671,-88671,-92071,OK
215.453,auto,Tick,1162,1179,-17,17,150200,149600,19671,-88671,-92071,OK
215.75,auto,Tick,1162,1179,-17,17,150200,149600,19671,-88671,-92071,OK
215.969,auto,Tick,1168,1179,-11,17,149500,149600,19581,-985581,-86881,OK
216.203,auto,Tick,1168,1179,-11,11,149500,149600,19581,-89781,-88681,OK
216.532,auto,Tick,1168,1179,-11,11,149500,149700,19581,-89781,-87581,OK
216.703,auto,Tick,1178,1179,-1,1,149700,149700,19880,-89080,-89080,OK
216.969,auto,Tick,1188,1179,9,-9,149100,150000,19865,-89165,-91865,OK
217.219,auto,Tick,1198,1179,19,-19,149500,150000,20164,-85464,-91164,OK
217.469,auto,Tick,1208,1179,29,-29,149500,150100,20463,-81763,-90463,OK
217.703,auto,Tick,1208,1179,29,-29,149500,150100,20463,-81763,-90463,OK
218.047,auto,Tick,1208,1179,29,-29,149500,149900,20463,-81763,-90463,OK
218.266,auto,Tick,1208,1179,29,-29,149500,149900,20463,-81763,-90463,OK
218.469,auto,Tick,1208,1179,29,-29,149500,149900,20463,-81763,-90463,OK
218.797,auto,Tick,1208,1179,29,-29,149500,149900,20463,-81763,-90463,OK
218.953,auto,Tick,1208,1179,29,-29,149500,149900,20463,-81763,-90463,OK
219.203,auto,Tick,1208,1189,19,-19,150500,149900,20313,-83613,-77913,OK
219.485,auto,Tick,1208,1199,9,-9,150400,149900,20163,-85463,-82763,OK
219.766,auto,Tick,1208,1199,9,-9,150400,149900,20163,-85463,-82763,OK
219.953,auto,Tick,1208,1209,-1,1,150500,149900,20013,-85313,-85613,OK
220.203,auto,Tick,1208,1209,-1,1,150500,149900,20013,-85313,-85613,OK
220.547,auto,Tick,1208,1209,-1,1,150500,149900,20013,-85313,-85613,OK
220.813,auto,Tick,1208,1209,-1,1,150500,150000,20013,-85313,-85613,OK
221.0,auto,Tick,1208,1219,-11,11,150500,150000,19863,-84163,-87463,OK
221.219,auto,Tick,1208,1219,-11,11,150500,150000,19863,-84163,-87463,OK
221.547,auto,Tick,1208,1219,-11,11,150500,150100,19863,-84163,-87463,OK
221.75,auto,Tick,1208,1219,-11,11,150500,150100,19863,-84163,-87463,OK
222.0,auto,Tick,1208,1219,-11,11,150500,150100,19863,-84163,-87463,OK
222.235,auto,Tick,1208,1219,-11,11,150500,150100,19863,-84163,-87463,OK
222.469,auto,Tick,1208,1219,-11,11,150500,150100,19863,-84163,-87463,OK
222.75,auto,Tick,1218,1219,-1,1,149500,150100,19713,-86013,-85713,OK
223.016,auto,Tick,1218,1219,-1,1,149500,150000,19713,-86013,-85713,OK
223.219,auto,Tick,1218,1219,-1,1,149500,150000,19713,-86013,-85713,OK
223.453,auto,Tick,1218,1219,-1,1,149500,150000,19713,-86013,-85713,OK
223.75,auto,Tick,1218,1229,-11,11,150300,150000,19563,-84863,-88163,OK
224.0,auto,Tick,1218,1239,-21,21,150400,150000,19864,-83164,-89464,OK
224.25,auto,Tick,1218,1245,-27,27,150400,150000,20044,-80944,-89044,OK
224.547,auto,Tick,1218,1245,-27,27,150400,150000,20044,-80944,-89044,OK
224.75,auto,Tick,1218,1245,-27,27,150400,149800,20044,-80944,-89044,OK
225.032,auto,Tick,1218,1255,-37,37,150100,149400,20344,-77244,-84644,OK
225.235,auto,Tick,1218,1255,-37,37,150100,149500,20344,-77244,-84644,OK
225.5,auto,Tick,1218,1255,-37,37,150100,149500,20344,-77244,-84644,OK
225.719,auto,Tick,1218,1255,-37,37,150100,149500,20344,-77244,-84644,OK
225.969,auto,Tick,1218,1255,-37,37,150100,149500,20344,-77244,-84644,OK
226.266,auto,Tick,1228,1255,-27,27,149300,149500,20194,-80094,-74694,OK
226.469,auto,Tick,1228,1255,-27,27,149300,149500,20194,-80094,-74694,OK
226.75,auto,Tick,1228,1265,-37,37,150300,149500,20044,-77944,-85344,OK
227.016,auto,Tick,1228,1265,-37,37,150300,149500,20044,-77944,-85344,OK
227.219,auto,Tick,1228,1265,-37,37,150300,149500,20044,-77944,-85344,OK
227.485,auto,Tick,1238,1265,-27,27,150400,150200,20345,-82245,-87645,OK
227.797,auto,Tick,1243,1265,-22,22,150500,150600,20495,-83395,-81195,OK
227.969,auto,Tick,1253,1265,-12,12,150600,150800,20796,-81696,-79296,OK
228.282,auto,Tick,1263,1265,-2,2,150600,150600,21097,-80997,-80997,OK
228.453,auto,Tick,1273,1265,8,-8,150600,150600,21398,-80298,-80298,OK
228.766,auto,Tick,1283,1265,18,-18,150600,150600,21699,-80599,-80599,OK
228.953,auto,Tick,1287,1265,22,-22,150500,150600,21639,-80139,-82339,OK
229.297,auto,Tick,1287,1265,22,-22,150500,150600,21639,-80139,-82339,OK
229.532,auto,Tick,1287,1265,22,-22,150500,150600,21639,-80139,-82339,OK
229.703,auto,Tick,1287,1265,22,-22,150500,150600,21639,-80139,-82339,OK
230.0,auto,Tick,1287,1265,22,-22,150500,150600,21639,-80139,-82339,OK
230.266,auto,Tick,1287,1265,22,-22,150600,150700,21639,-80139,-82339,OK
230.5,auto,Tick,1287,1265,22,-22,150600,150700,21639,-80139,-82339,OK
230.735,auto,Tick,1287,1265,22,-22,150600,150700,21639,-80139,-82339,OK
231.047,auto,Tick,1287,1265,22,-22,150600,150700,21639,-80139,-82339,OK
231.282,auto,Tick,1287,1265,22,-22,150600,150700,21639,-80139,-82339,OK
231.516,auto,Tick,1287,1265,22,-22,150600,150700,21639,-80139,-82339,OK
231.766,auto,Tick,1287,1265,22,-22,150600,150700,21639,-80139,-82339,OK
232.047,auto,Tick,1287,1265,22,-22,150600,150700,21639,-80139,-82339,OK
232.235,auto,Tick,1287,1265,22,-22,150600,150700,21639,-80139,-82339,OK
232.5,auto,Tick,1287,1265,22,-22,150600,150700,21639,-80139,-82339,OK
232.719,auto,Tick,1297,1265,32,-32,150600,150700,21940,-78440,-81640,OK
233.047,auto,Tick,1297,1265,32,-32,150600,150700,21940,-78440,-81640,OK
233.235,auto,Tick,1307,1265,42,-42,150700,151100,22242,-75242,-87842,OK
233.547,auto,Tick,1307,1265,42,-42,150700,151100,22242,-75242,-87842,OK
233.813,auto,Tick,1307,1265,42,-42,150700,151100,22242,-75242,-87842,OK
234.047,auto,Tick,1307,1265,42,-42,150700,151100,22242,-75242,-87842,OK
234.235,auto,Tick,1307,1265,42,-42,150700,151100,22242,-75242,-87842,OK
234.5,auto,Tick,1307,1265,42,-42,150700,151200,22242,-75242,-87842,OK
234.703,auto,Tick,1307,1265,42,-42,150700,151200,22242,-75242,-87842,OK
234.953,auto,Tick,1317,1265,52,-52,150800,151200,22544,-71544,-87144,OK
235.203,auto,Tick,1317,1275,42,-42,150900,151500,22393,-79393,-91993,OK
